--------------
-ooo.---------
-oSoooo-------
-ooo......----
--oo......o---
-------ooooo--
-------ooT----
--------------